X>........
......<<..
..........
.....>v...
.^...^v...
.^....>>8.
